Arts

saisissant : striking
faire un croquis / esquisser : to sketch
mettre en valeur : enhance
huer : to boo
siffler : to hiss
accoder : to tune
concevoir : to plan
doubler : to dub
une représentation : performance
l'apogée : climax


Food

l'agneau : lamb
la volaile : poultry
oeufs brouillés : scrambled eggs
donner un pourboire : to tip
macher : to chew
régaler : to treat
préparer un repas : to cater
hachis parmentier : sheperd's pie
brochette : a kebab
rassis : stale


Science and research

vide : vacuum
balance : scales
deroutant : bewildering
sorcier : wizard
percée : inroad
érudit : scholar
groupe d'experts : thinktank
être à l'avant garde : to spearhead
maitriser : to harness
manipuler : to tamper with


Social life

aide sociale : welfare
vogue : fad
fardeau : burden
oisiveté : idleness
querelle : quarrel
ragots : gossip
sournois : sly
osé : bold
venir en aide : to relieve
expusler : to evict

